[1][6][6][6][6][1][1][1][7][7][7][7][7][7][7]
[6][0][0][0][6][0][0][-8][0][0][0][0][0][0][7]
[6][0][0][0][6][0][0][1][7][7][7][-7][7][0][7]
[6][0][0][0][6][0][0][1][0][1][7][0][7][0][7]
[6][6][2][6][6][0][0][1][0][14][0][0][7][0][7]
[1][0][0][0][0][0][0][1][1][1][7][7][7][0][7]
[1][6][2][6][1][0][0][1][0][0][0][0][7][0][7]
[6][0][0][6][1][0][0][1][0][0][0][0][7][0][7]
[6][0][0][6][1][0][0][1][0][0][0][0][7][0][7]
[6][0][0][6][1][0][0][1][6][6][6][6][7][0][7]
[6][6][6][6][1][5][5][1][6][0][0][6][7][0][7]
[1][0][0][1][0][0][0][1][6][0][0][6][7][0][7]
[1][0][0][1][0][0][0][1][6][0][6][6][7][0][7]
[1][0][0][1][0][0][0][1][1][2][1][1][7][0][7]
[1][1][1][1][0][0][0][0][0][0][0][1][7][0][7]
[1][0][0][0][0][0][0][0][0][0][0][1][7][0][7]
[1][0][1][1][1][2][1][1][1][1][0][1][7][0][7]
[1][5][1][1][6][0][6][6][6][1][0][1][7][0][7]
[1][0][0][1][6][0][0][6][6][1][0][1][7][0][7]
[1][0][0][1][6][6][6][6][6][1][0][1][7][0][7]
[1][0][0][1][1][1][1][1][1][1][0][1][7][0][7]
[1][0][0][5][0][0][0][0][0][0][0][1][7][0][7]
[1][0][0][1][1][1][1][1][1][5][5][1][7][0][7]
[1][0][0][1][6][6][6][6][1][0][0][1][7][0][7]
[1][0][0][1][6][0][0][6][1][0][0][1][7][0][7]
[1][0][0][2][0][0][0][6][1][0][0][1][7][0][7]
[1][0][0][1][6][6][6][6][1][0][0][1][7][0][7]
[1][0][0][1][1][1][1][1][1][0][0][1][7][0][7]
[1][0][0][0][0][0][0][0][0][0][0][1][7][0][7]
[1][0][0][0][0][0][0][0][0][0][0][1][7][0][7]
[1][0][0][0][1][1][1][2][1][1][1][1][7][0][7]
[1][1][5][1][1][1][1][0][1][1][1][1][7][0][7]
[1][0][0][0][1][0][0][0][0][0][0][1][7][0][7]
[1][0][0][0][1][0][0][0][0][0][0][1][7][0][7]
[1][0][0][0][1][0][0][0][0][0][0][1][7][0][7]
[1][0][0][0][1][0][0][0][0][0][0][1][7][0][7]
[1][0][0][0][1][0][0][0][0][0][0][1][7][0][7]
[1][1][15][1][1][0][0][0][0][0][0][1][7][0][7]
[1][6][0][6][1][1][1][1][1][5][1][1][7][0][7]
[1][6][0][6][0][1][0][0][13][0][1][1][7][0][7]
[1][6][0][6][0][1][0][0][12][0][1][7][7][0][7]
[1][6][6][6][0][1][0][0][12][0][-8][0][0][0][7]
[1][0][0][0][0][1][0][0][11][0][1][7][7][0][7]
[1][1][1][1][1][1][15][1][1][5][1][1][1][-1][1]
[1][0][0][0][0][0][0][0][0][0][0][1][0][0][1]
[1][0][0][0][0][0][0][0][0][0][0][1][0][0][1]
[1][0][0][0][0][0][0][0][0][0][0][1][0][0][1]
[1][0][0][1][1][1][1][1][1][1][1][1][0][0][1]
[1][0][0][1][0][0][0][0][0][0][0][1][0][0][1]
[1][0][0][1][1][1][1][1][1][1][1][1][0][0][1]
[1][0][0][0][0][0][0][0][0][0][0][0][0][0][1]
[1][0][0][0][0][0][0][0][0][0][0][0][0][0][1]
[1][1][1][1][1][1][1][1][5][5][1][1][1][1][1]
[1][0][0][0][0][0][0][1][0][0][1][0][0][0][1]
[1][0][0][0][0][0][0][1][0][0][1][0][0][0][1]
[1][0][0][0][0][0][0][1][0][0][1][0][0][0][1]
[1][0][0][0][0][0][0][1][9][10][1][0][0][0][1]
[1][0][0][0][0][0][0][0][0][0][0][0][0][0][1]
[1][0][0][0][0][0][0][0][0][0][0][0][0][0][1]
[1][1][1][1][1][1][1][1][1][1][1][1][1][1][1]
