[6][6][6][6][1][1][1][1][1][1][1][1][1][1]
[6][0][0][6][1][0][1][1][0][0][0][0][0][1]
[6][0][0][6][1][0][1][1][0][0][0][0][0][1]
[6][6][2][6][1][0][1][1][0][0][0][0][0][1]
[1][1][0][1][1][0][1][1][0][0][0][0][0][1]
[1][0][0][0][0][0][1][1][0][0][0][0][0][1]
[1][1][1][0][0][0][1][1][0][0][0][0][0][1]
[1][0][1][2][1][0][5][0][0][0][0][0][0][1]
[1][0][0][0][1][1][1][0][0][0][0][0][0][1]
[1][0][0][0][0][0][1][1][0][0][0][0][0][1]
[1][0][0][0][0][0][1][1][0][0][0][0][0][1]
[1][1][1][2][1][1][1][1][0][0][0][0][0][1]
[1][0][0][0][0][0][1][1][0][0][0][0][0][1]
[1][0][0][0][0][0][1][1][0][0][0][0][0][1]
[1][0][0][0][0][0][1][1][0][0][0][0][0][1]
[1][1][1][1][1][1][1][1][1][1][1][1][1][1]
